"filename", "language", "C#", "comment", "blank", "total"
"g:\ToyEmpires\ToyEmpires\ToyEmpires\Assets\Scripts\ColliderToObstacle.cs", "C#", 19, 0, 3, 22
"g:\ToyEmpires\ToyEmpires\ToyEmpires\Assets\Scripts\GameUI\DataLineUI.cs", "C#", 20, 0, 5, 25
"g:\ToyEmpires\ToyEmpires\ToyEmpires\Assets\Scripts\GameUI\DispatchUnitUI.cs", "C#", 15, 0, 4, 19
"g:\ToyEmpires\ToyEmpires\ToyEmpires\Assets\Scripts\GameUI\EconomicDataPanelUI.cs", "C#", 26, 0, 5, 31
"g:\ToyEmpires\ToyEmpires\ToyEmpires\Assets\Scripts\GameUI\UnitButtonUI.cs", "C#", 108, 0, 15, 123
"g:\ToyEmpires\ToyEmpires\ToyEmpires\Assets\Scripts\GameUI\UnitDispatchManagerUI.cs", "C#", 38, 0, 9, 47
"g:\ToyEmpires\ToyEmpires\ToyEmpires\Assets\Scripts\GameUI\UnitUI\UnitStatusBarUI.cs", "C#", 34, 0, 9, 43
"g:\ToyEmpires\ToyEmpires\ToyEmpires\Assets\Scripts\GameUI\WorkerDispatchUI.cs", "C#", 53, 0, 8, 61
"g:\ToyEmpires\ToyEmpires\ToyEmpires\Assets\Scripts\GameUI\WorkerPanelUI.cs", "C#", 27, 0, 5, 32
"g:\ToyEmpires\ToyEmpires\ToyEmpires\Assets\Scripts\Gameplay\BattleGameManager.cs", "C#", 34, 1, 8, 43
"g:\ToyEmpires\ToyEmpires\ToyEmpires\Assets\Scripts\Gameplay\Buff\BuffBase.cs", "C#", 52, 0, 16, 68
"g:\ToyEmpires\ToyEmpires\ToyEmpires\Assets\Scripts\Gameplay\Buff\BuffContainerBase.cs", "C#", 25, 0, 5, 30
"g:\ToyEmpires\ToyEmpires\ToyEmpires\Assets\Scripts\Gameplay\Buff\BuffTask.cs", "C#", 32, 0, 5, 37
"g:\ToyEmpires\ToyEmpires\ToyEmpires\Assets\Scripts\Gameplay\Buff\BuffTimingTask.cs", "C#", 26, 0, 5, 31
"g:\ToyEmpires\ToyEmpires\ToyEmpires\Assets\Scripts\Gameplay\Buff\PlayerBuffBase.cs", "C#", 9, 0, 3, 12
"g:\ToyEmpires\ToyEmpires\ToyEmpires\Assets\Scripts\Gameplay\Buff\PlayerBuffContainer.cs", "C#", 9, 0, 2, 11
"g:\ToyEmpires\ToyEmpires\ToyEmpires\Assets\Scripts\Gameplay\Buff\UnitBuffBase.cs", "C#", 9, 0, 2, 11
"g:\ToyEmpires\ToyEmpires\ToyEmpires\Assets\Scripts\Gameplay\Buff\UnitBuffContainer.cs", "C#", 9, 0, 2, 11
"g:\ToyEmpires\ToyEmpires\ToyEmpires\Assets\Scripts\Gameplay\GameUnit\FortificationUnit\FortificationUnitBase.cs", "C#", 79, 2, 16, 97
"g:\ToyEmpires\ToyEmpires\ToyEmpires\Assets\Scripts\Gameplay\GameUnit\FortificationUnit\JuMa.cs", "C#", 7, 0, 3, 10
"g:\ToyEmpires\ToyEmpires\ToyEmpires\Assets\Scripts\Gameplay\GameUnit\FortificationUnit\TowerBase.cs", "C#", 221, 6, 39, 266
"g:\ToyEmpires\ToyEmpires\ToyEmpires\Assets\Scripts\Gameplay\GameUnit\GameAIUnitPath.cs", "C#", 15, 0, 3, 18
"g:\ToyEmpires\ToyEmpires\ToyEmpires\Assets\Scripts\Gameplay\GameUnit\GameUnitBase.cs", "C#", 58, 1, 11, 70
"g:\ToyEmpires\ToyEmpires\ToyEmpires\Assets\Scripts\Gameplay\GameUnit\GameUnitHelper.cs", "C#", 14, 0, 2, 16
"g:\ToyEmpires\ToyEmpires\ToyEmpires\Assets\Scripts\Gameplay\GameUnit\IDefenable.cs", "C#", 15, 0, 5, 20
"g:\ToyEmpires\ToyEmpires\ToyEmpires\Assets\Scripts\Gameplay\GameUnit\IProduceable.cs", "C#", 15, 0, 1, 16
"g:\ToyEmpires\ToyEmpires\ToyEmpires\Assets\Scripts\Gameplay\GameUnit\PlayerHomeUnit.cs", "C#", 43, 0, 7, 50
"g:\ToyEmpires\ToyEmpires\ToyEmpires\Assets\Scripts\Gameplay\GameUnit\SoldierUnit\CombatUnit\AttackEventHandler.cs", "C#", 4, 0, 0, 4
"g:\ToyEmpires\ToyEmpires\ToyEmpires\Assets\Scripts\Gameplay\GameUnit\SoldierUnit\CombatUnit\IAttackable.cs", "C#", 13, 0, 6, 19
"g:\ToyEmpires\ToyEmpires\ToyEmpires\Assets\Scripts\Gameplay\GameUnit\SoldierUnit\CombatUnit\MeleeUnit\MeleeUnitsBase.cs", "C#", 215, 3, 43, 261
"g:\ToyEmpires\ToyEmpires\ToyEmpires\Assets\Scripts\Gameplay\GameUnit\SoldierUnit\CombatUnit\MeleeUnit\Swordsman.cs", "C#", 6, 0, 1, 7
"g:\ToyEmpires\ToyEmpires\ToyEmpires\Assets\Scripts\Gameplay\GameUnit\SoldierUnit\CombatUnit\RangedAttackUnit\Archer.cs", "C#", 8, 0, 1, 9
"g:\ToyEmpires\ToyEmpires\ToyEmpires\Assets\Scripts\Gameplay\GameUnit\SoldierUnit\CombatUnit\RangedAttackUnit\IRangeAttackable.cs", "C#", 17, 0, 7, 24
"g:\ToyEmpires\ToyEmpires\ToyEmpires\Assets\Scripts\Gameplay\GameUnit\SoldierUnit\CombatUnit\RangedAttackUnit\RangedAttackUnitBase.cs", "C#", 274, 7, 57, 338
"g:\ToyEmpires\ToyEmpires\ToyEmpires\Assets\Scripts\Gameplay\GameUnit\SoldierUnit\GameUnitMover.cs", "C#", 75, 0, 15, 90
"g:\ToyEmpires\ToyEmpires\ToyEmpires\Assets\Scripts\Gameplay\GameUnit\SoldierUnit\IMovable.cs", "C#", 8, 0, 1, 9
"g:\ToyEmpires\ToyEmpires\ToyEmpires\Assets\Scripts\Gameplay\GameUnit\SoldierUnit\SoldierUnitBase.cs", "C#", 107, 1, 33, 141
"g:\ToyEmpires\ToyEmpires\ToyEmpires\Assets\Scripts\Gameplay\GameUnit\SoldierUnit\Worker\Worker.cs", "C#", 137, 4, 25, 166
"g:\ToyEmpires\ToyEmpires\ToyEmpires\Assets\Scripts\Gameplay\GameUnit\ThrowingObject\Arrow.cs", "C#", 6, 0, 2, 8
"g:\ToyEmpires\ToyEmpires\ToyEmpires\Assets\Scripts\Gameplay\GameUnit\ThrowingObject\ThrowingObjectBase.cs", "C#", 86, 0, 14, 100
"g:\ToyEmpires\ToyEmpires\ToyEmpires\Assets\Scripts\Gameplay\GameUnit\ThrowingObject\ThrowingObjectHandler.cs", "C#", 5, 0, 1, 6
"g:\ToyEmpires\ToyEmpires\ToyEmpires\Assets\Scripts\Gameplay\GameUnit\UnitStatus.cs", "C#", 13, 0, 1, 14
"g:\ToyEmpires\ToyEmpires\ToyEmpires\Assets\Scripts\Gameplay\GameUnit\UnitVisualField.cs", "C#", 35, 0, 12, 47
"g:\ToyEmpires\ToyEmpires\ToyEmpires\Assets\Scripts\Gameplay\Player\AI\PlayerAI.DispatchPlan.cs", "C#", 64, 0, 9, 73
"g:\ToyEmpires\ToyEmpires\ToyEmpires\Assets\Scripts\Gameplay\Player\AI\PlayerAI.cs", "C#", 155, 50, 33, 238
"g:\ToyEmpires\ToyEmpires\ToyEmpires\Assets\Scripts\Gameplay\Player\PlayerBase.cs", "C#", 280, 16, 56, 352
"g:\ToyEmpires\ToyEmpires\ToyEmpires\Assets\Scripts\Gameplay\ResourceType.cs", "C#", 9, 0, 2, 11
"g:\ToyEmpires\ToyEmpires\ToyEmpires\Assets\Scripts\Gameplay\Road.cs", "C#", 9, 0, 0, 9
"g:\ToyEmpires\ToyEmpires\ToyEmpires\Assets\Scripts\Gameplay\Team.cs", "C#", 8, 0, 0, 8
"g:\ToyEmpires\ToyEmpires\ToyEmpires\Assets\Scripts\PathFindingPlus\CustomPathFinding.cs", "C#", 12, 0, 3, 15
"g:\ToyEmpires\ToyEmpires\ToyEmpires\Assets\Scripts\Rendering\SpriteRendererPlus.cs", "C#", 81, 8, 6, 95
"g:\ToyEmpires\ToyEmpires\ToyEmpires\Assets\Scripts\SimpleCameraController.cs", "C#", 241, 9, 44, 294
"g:\ToyEmpires\ToyEmpires\ToyEmpires\Assets\Scripts\TestScript.cs", "C#", 12, 0, 2, 14
"Total", "-", 2892, 108, 572, 3572